#############
#...#..##...#
#..#.....##.#
###..##.....#
#.#.....#...#
#...##.##...#
#..#####....#
#.@..#...##.#
#############